OOOOOOOHOOOOOHOOOOOOOOOHOOOOOOOHOOOOOOOOOHOOOOOHOOOOOOOOOHOOOOOOOOOOOOOHOOOOOHOOOOOOOOOOOHOOOOOOOOOH
OHHHHHOHOHHHOHOHHHHHHHOHOHHHHHOHHHHHHHOHOHOHHHOHHHHHOHHHHHOHHHHHOHHHHHOHOHHHOHOHHHOHHHHHOHHHOHOHHHHH
OHOOOOOHOHOOOHOOOOOOOHOOOHOOOOOOOOOOOOOHOHOOOHOHOOOOOHOOOOOHOOOOOHOOOHOOOHOHOHOOOHOHOOOHOOOHOHOOOOOH
HHOHHHHHOHHHOHHHHHHHOHHHHHHHHHHHHHHHHHHHOHOHOHOHOHHHOHOHHHHHOHHHHHOHHHHHHHOHOHHHHHOHHHOHHHOHOHHHHHOH
OHOHOOOOOOOHOOOOOOOOOHOOOOOOOOOHOOOHOOOOOHOHOHOHOOOHOHOHOOOOOHOOOOOOOOOOOOOHOOOOOOOHOOOHOOOHOHOOOOOH
OHOHOHHHHHOHHHOHHHHHHHOHHHHHHHOHOHHHOHHHHHHHOHOHHHOHHHOHOHHHHHHHHHOHHHHHHHOHHHHHHHHHOHHHOHHHOHOHHHOH
OHOHOHOHOOOHOOOHOOOOOOOHOOOOOHOHOOOOOHOOOOOOOHOOOHOHOOOHOOOHOOOOOHOOOHOOOOOOOOOHOOOHOOOOOHOOOHOOOHOH
OHOHOHOHOHHHOHHHOHHHHHHHHHHHOHOHHHHHOHOHHHHHHHHHOHOHOHHHHHOHOHHHOHHHHHOHOHHHHHOHOHOHOHHHHHHHHHHHOHOH
OOOHOOOHOHOOOOOHOOOHOOOOOOOHOHOOOOOHOHOOOOOOOHOOOHOOOOOHOOOHOHOOOOOOOOOHOHOOOHOHOHOOOOOOOOOOOOOOOHOH
OHHHHHOHOHHHHHOHHHOHHHHHOHOHOHHHHHOHOHHHHHHHOHOHHHHHHHOHOHHHOHHHOHHHHHHHHHOHOHHHOHHHHHHHHHHHHHHHHHHH
OOOHOOOHOOOHOHOHOOOHOOOOOHOOOHOOOOOHOHOOOOOOOHOOOOOOOHOHOOOHOOOHOHOOOHOOOHOHOHOOOOOHOOOOOOOOOOOHOOOH
HHOHHHOHHHOHOHOHOHHHOHHHHHHHOHOHHHHHOHOHHHHHHHHHHHHHOHOHHHOHHHOHHHOHOHOHOHOHOHOHHHHHOHHHHHHHHHOHOHOH
OHOOOHOHOOOHOOOHOOOHOOOHOOOOOHOOOHOOOOOHOOOOOOOOOHOOOHOOOHOOOHOOOHOHOOOHOOOHOOOHOOOOOHOOOOOOOHOOOHOH
OHHHOHHHOHHHHHHHHHOHOHOHHHHHOHHHOHHHHHHHOHHHHHHHOHOHHHHHHHOHOHOHOHOHHHHHHHHHHHHHOHHHHHOHOHOHHHHHHHOH
OOOHOOOHOOOOOHOOOHOHOHOOOOOHOHOHOOOHOOOHOHOOOOOHOOOHOOOOOHOHOHOHOHOOOOOHOOOOOOOOOHOOOHOHOHOHOOOOOOOH
OHOHHHOHHHHHOHOHOHOHHHHHHHOHOHOHHHOHOHOHOHOHHHOHHHHHHHOHOHOHOHHHOHOHHHHHOHHHHHHHHHOHHHOHOHOHOHHHHHHH
OHOOOHOOOOOHOHOHOOOOOOOOOOOHOOOHOOOHOHOHOOOHOHOOOOOOOOOHOHOHOOOHOOOHOOOOOHOOOOOHOOOOOOOHOHOHOOOOOOOH
OHHHHHHHHHOHOHOHHHHHHHHHHHHHHHOHOHHHHHOHHHHHOHHHHHHHHHHHOHOHHHOHHHHHOHHHHHOHHHOHHHHHHHHHOHOHHHHHOHOH
OOOHOOOOOHOHOOOOOHOOOOOHOOOOOOOHOOOOOHOOOOOOOOOHOOOOOHOOOHOOOHOHOOOOOHOOOOOHOOOOOHOOOHOOOHOHOOOHOHOH
HHOHOHOHOHOHHHHHHHOHHHOHOHHHHHHHHHHHOHOHHHHHHHHHOHHHOHOHHHHHHHOHOHHHHHOHOHHHHHHHOHOHOHOHHHOHOHOHHHOH
OOOHOHOHOHOOOHOOOOOHOHOHOHOOOOOOOHOOOHOOOOOHOOOHOHOHOOOHOOOOOHOHOHOOOOOHOHOOOOOHOOOHOHOOOHOHOHOOOOOH
OHHHOHOHHHHHOHOHHHHHOHOHOHHHHHOHHHOHHHOHHHOHOHOHOHOHHHHHOHHHOHOHOHHHOHHHOHOHHHOHHHHHOHOHOHHHOHHHHHOH
OOOHOHOHOOOOOHOHOOOOOOOHOOOOOOOHOOOHOOOHOHOOOHOOOHOOOOOHOHOOOOOHOOOHOHOHOOOOOHOOOOOHOHOHOOOHOOOHOOOH
HHOHOHOHOHHHHHOHHHHHHHOHHHHHHHHHOHHHOHHHOHHHHHHHHHOHHHOHOHHHHHHHHHOHOHOHHHHHHHHHHHOHOHHHHHOHHHOHHHOH
OOOHOHOOOHOOOOOHOOOOOHOHOOOOOHOOOHOHOOOOOHOOOOOOOOOOOHOHOOOHOOOOOOOHOOOOOHOOOHOOOHOHOOOHOOOOOHOOOHOH
OHOHOHHHHHHHOHHHOHHHOHOHOHHHOHOHHHOHHHHHOHHHHHHHHHOHOHOHHHOHOHHHHHHHHHHHHHOHOHOHOHOHHHOHOHHHOHHHOHHH
OHOHOHOOOOOHOOOOOOOHOHOHOHOOOHOHOOOOOHOOOHOOOOOOOHOHOHOOOHOOOOOOOOOOOOOOOHOHOOOHOOOHOHOHOOOHOOOHOOOH
OHHHOHOHHHOHHHHHHHHHOHOHOHOHHHOHOHHHHHOHHHOHHHHHOHHHOHHHOHHHHHHHHHHHHHHHOHOHHHHHHHHHOHOHHHOHHHOHHHOH
OOOOOHOHOHOOOHOOOOOOOHOOOHOHOOOHOHOOOOOHOOOOOHOHOOOOOHOHOOOOOHOOOOOHOOOOOHOOOHOOOOOOOHOOOHOOOHOHOOOH
OHHHHHOHOHHHOHOHHHHHHHHHHHOHOHHHOHOHHHHHHHHHOHOHHHHHHHOHHHHHOHHHOHOHOHHHHHOHOHOHHHHHHHHHOHHHOHHHOHHH
OOOHOOOHOOOOOHOOOHOOOOOHOOOOOHOOOHOHOOOOOOOOOHOOOOOOOOOOOOOHOOOHOHOOOHOHOOOHOHOOOOOOOOOHOOOHOOOHOOOH
HHOHOHHHOHHHHHHHOHOHHHOHHHHHHHOHHHOHOHOHHHHHHHHHHHHHHHOHHHOHHHOHOHHHHHOHOHHHOHHHHHHHOHHHHHOHHHOHHHOH
OHOOOHOHOHOOOOOOOHOOOHOOOHOOOHOOOOOHOHOOOHOOOHOOOOOHOOOHOOOOOHOHOHOOOOOOOOOHOOOHOOOHOOOOOOOOOOOOOHOH
OHHHHHOHOHOHHHHHHHHHOHHHOHHHOHOHHHHHOHHHOHOHOHOHHHOHOHHHHHHHHHOHOHHHHHHHHHOHHHOHOHOHHHHHHHHHHHOHHHOH
OOOHOOOOOHOHOOOOOOOOOHOHOOOHOHOHOOOOOOOHOOOHOOOHOOOHOOOOOOOHOOOHOOOOOOOHOOOOOHOOOHOOOOOHOOOHOHOHOOOH
OHOHOHHHHHOHOHHHHHHHHHOHHHOHOHOHHHHHHHHHHHOHHHHHOHHHOHHHHHOHOHHHHHHHHHOHHHHHHHHHHHHHHHOHOHOHOHOHOHOH
OHOHOHOOOOOHOHOOOOOHOOOOOHOHOHOHOOOHOOOOOHOOOHOOOHOOOHOHOOOHOOOOOHOOOOOHOOOOOOOOOOOOOHOHOHOHOOOHOHOH
OHOHOHOHHHHHOHHHOHOHOHOHHHOHOHOHOHOHOHHHOHHHOHOHHHOHHHOHOHOHHHHHOHOHHHHHOHHHHHHHHHHHOHOHOHOHHHHHOHOH
OHOHOHOOOOOOOHOOOHOOOHOHOOOHOHOHOHOHOOOHOHOOOHOOOHOOOOOHOHOOOOOHOHOOOOOOOHOOOOOHOOOHOHOHOHOOOHOOOHOH
OHOHOHHHHHHHOHOHHHHHOHHHOHHHOHOHOHOHHHOHOHOHHHHHOHHHHHHHOHHHHHOHOHHHHHHHHHOHHHOHOHHHOHOHOHHHOHOHHHHH
OHOOOHOOOOOHOOOHOHOOOHOOOHOHOOOHOHOOOOOHOHOHOOOOOHOOOOOHOOOHOOOHOOOOOHOOOOOHOHOHOOOHOHOOOHOOOHOOOOOH
OHHHHHOHHHOHHHHHOHOHHHOHHHOHOHHHOHHHHHHHOHOHOHHHHHOHHHOHOHOHOHHHHHHHOHOHHHHHOHOHHHOHOHOHHHOHHHHHHHOH
OHOOOHOOOHOOOOOHOOOHOOOHOOOHOOOHOOOHOOOOOHOHOOOOOOOHOHOHOHOHOOOHOOOHOOOHOOOHOHOOOHOOOHOOOHOOOOOOOHOH
OHOHOHHHOHHHHHOHHHHHOHHHOHOHHHOHOHOHOHHHHHOHHHHHOHHHOHOHOHOHHHOHHHOHHHHHOHOHOHHHOHOHHHHHOHHHHHHHOHOH
OOOHOOOOOHOOOOOHOOOOOHOOOHOHOOOHOHOHOOOOOHOHOOOHOOOOOHOHOHOHOOOOOHOOOHOOOHOOOOOHOHOOOOOHOOOOOHOOOHOH
HHHHHHHHHHOHHHHHOHHHHHOHHHOHOHHHHHOHHHHHOHHHOHOHHHHHHHOHHHOHHHHHOHOHOHHHOHHHOHHHOHHHHHOHHHHHOHOHOHOH
OOOOOOOOOHOHOOOOOHOOOOOHOOOHOHOOOOOHOOOHOHOOOHOOOOOOOOOHOOOHOOOHOOOHOOOHOOOHOHOOOHOOOOOHOOOHOHOHOHOH
OHHHHHHHOHOHOHHHHHOHHHHHOHHHOHOHHHHHOHHHOHOHHHHHOHHHHHHHOHHHOHOHHHHHHHOHHHOHHHOHHHOHHHHHOHOHHHOHOHOH
OOOHOOOHOHOOOHOHOOOOOHOOOHOHOHOHOOOOOHOOOHOOOOOHOHOOOHOOOOOOOHOHOOOOOOOOOOOHOOOHOHOOOOOHOHOOOOOHOHOH
HHHHOHOHOHHHHHOHOHHHOHOHHHOHOHOHHHOHHHOHHHOHHHOHHHOHOHHHOHHHHHOHOHHHHHHHHHHHOHHHOHHHHHOHOHHHHHHHHHOH
OOGOOOOOOOOOOOOOOOOOOOOOOOOOOOOOOOOHOOOHOOOOOHOOOOOHOOOHOOOHOOOHOOOHOOOOOOOHOHOOOOOOOOOOOHOOOOOOOOOH
OHHHHHHHHHHHOHOHOHOHHHOHOHHHHHHHOHOHOHHHHHHHOHHHHHHHHHOHHHOHOHHHHHHHOHHHHHOHOHHHOHHHHHHHHHOHHHHHHHOH
OHOOOHOOOOOHOHOHOHOHOHOOOHOOOOOOOOOHOHOOOOOHOHOOOOOOOHOOOHOHOOOOOOOHOOOHOOOHOOOHOHOOOHOOOHOOOOOOOHOH
OHOHHHOHOHHHOHOHOHOHOHHHOHOHHHHHHHOHOHOHOHOHHHOHHHHHOHHHOHHHHHOHHHOHOHHHOHOHHHOHHHOHOHOHOHOHHHHHOHHH
OHOOOHOHOHOOOHOOOHOHOOOHOHOOOOOOOHOOOHOHOHOOOOOHOOOOOHOOOHOOOHOHOOOHOHOOOHOOOHOOOOOHOOOHOHOHOOOHOOOH
OHHHOHOHOHOHHHHHOHOHHHOHOHHHHHHHOHOHHHHHOHHHHHHHOHHHHHOHHHOHOHHHOHHHOHOHHHHHHHHHHHHHHHHHOHOHOHOHHHOH
OOOHOOOHOOOHOOOHOHOOOHOOOHOOOOOHOOOOOHOOOHOOOOOHOHOOOOOOOOOHOHOOOHOOOHOOOOOOOOOOOOOOOHOOOHOOOHOHOOOH
OHOHOHHHHHOHOHOHHHHHOHOHHHOHOHHHHHOHOHOHHHOHHHOHOHOHHHHHHHHHOHOHOHOHHHHHHHHHHHHHHHHHOHOHHHHHHHHHOHOH
OHOHOHOOOHOOOHOHOOOOOHOOOHOHOHOOOOOHOHOOOHOHOOOHOHOHOOOOOHOOOHOHOHOHOOOHOOOOOOOOOHOOOHOOOHOOOOOOOHOH
HHOHHHOHOHHHHHOHOHOHHHHHOHOHOHOHOHOHOHHHOHHHOHOHOHHHOHHHOHOHHHOHHHOHOHHHOHHHHHHHOHOHHHHHOHOHHHHHHHOH
OOOHOOOHOOOOOHOOOHOHOOOHOHOHOHOHOOOOOHOOOHOOOHOHOOOHOHOOOHOHOOOOOOOOOHOOOOOOOOOHOHOOOHOOOHOHOOOOOHOH
OHHHOHHHHHHHOHHHHHHHOHOHOHOHHHOHHHOHHHOHHHOHHHOHHHOHOHOHHHOHHHHHOHHHHHOHHHHHHHHHOHOHOHOHHHOHOHHHOHOH
OOOOOHOOOOOHOOOOOOOOOHOHOHOOOHOHOOOHOOOOOHOHOOOOOHOOOHOHOOOOOOOHOHOOOHOHOOOHOOOOOHOHOOOHOOOHOOOHOOOH
OHHHHHHHOHOHHHHHHHHHOHOHOHHHOHOHOHOHHHHHOHOHHHOHHHHHHHOHOHHHHHOHOHOHOHOHOHOHOHHHHHOHHHHHHHOHHHOHHHHH
OOOOOOOHOHOOOOOHOOOHOHOHOOOOOHOHOHOOOHOOOHOOOHOHOOOOOOOHOHOOOHOHOHOHOOOHOHOOOHOOOHOHOOOOOOOHOOOHOOOH
HHHHHHOHOHHHOHHHOHOHHHOHHHHHHHOHOHOHOHOHHHOHOHHHOHHHHHHHOHOHHHOHOHOHHHHHOHHHHHOHOHOHOHOHHHHHHHOHHHOH
OOOOOOOHOHOOOHOOOHOOOOOHOOOOOOOHOHOOOHOHOHOHOOOHOHOOOHOOOOOHOOOHOHOHOOOOOHOOOHOHOHOHOHOOOOOOOHOOOOOH
OHHHHHHHOHHHOHOHHHHHHHOHOHHHHHHHOHOHHHOHOHOHHHOHOHOHOHHHHHOHOHHHHHOHOHHHHHOHHHOHOHOHHHHHHHHHOHHHHHOH
OOOOOOOHOOOHOHOHOOOOOOOHOOOHOOOOOHOHOOOHOOOOOHOHOOOHOOOHOOOHOOOOOOOHOOOOOHOHOOOHOOOHOOOOOOOOOHOHOOOH
HHHHHHOHOHOHHHOHHHOHHHHHHHOHOHHHHHOHOHOHHHHHHHOHHHHHHHOHOHHHHHHHHHHHHHHHOHOHOHHHHHHHOHHHHHHHHHOHOHHH
OOOOOOOHOHOOOHOOOHOOOHOOOHOOOHOOOOOHOHOOOOOHOOOOOOOHOHOHOHOOOHOOOOOHOOOHOHOHOHOOOHOOOHOOOOOOOHOHOOOH
OHHHHHHHOHHHOHHHOHHHOHOHHHHHHHOHHHOHOHHHHHOHOHHHHHOHOHOHOHOHOHHHOHOHOHOHOHOHOHHHOHOHOHHHHHOHOHOHHHOH
OHOOOHOOOHOOOOOHOOOHOOOHOOOOOOOHOOOOOOOOOHOHOOOOOHOOOHOHOOOHOOOOOHOHOHOOOHOHOHOOOHOHOHOOOOOHOOOHOHOH
OHHHOHOHHHOHHHHHHHOHHHHHOHHHHHHHHHOHHHHHOHOHOHHHOHOHHHOHHHHHHHHHHHOHOHHHHHOHOHOHHHOHOHOHHHHHHHOHOHOH
OOOHOHOHOOOHOOOOOHOOOOOHOHOOOOOOOHOHOOOHOHOHOHOOOHOHOOOHOOOOOOOOOOOHOHOHOOOHOHOOOOOHOHOHOOOHOOOOOHOH
HHOHOHOHOHOHOHHHOHHHHHOHOHOHHHHHOHOHOHOHHHOHOHOHHHOHOHHHOHHHHHHHHHHHOHOHOHOHOHHHHHHHOHOHOHOHHHHHHHOH
OHOHOHOHOHOHOOOHOOOHOOOHOOOHOOOHOOOOOHOOOHOHOHOHOOOHOOOHOHOOOOOOOOOHOHOOOHOOOOOOOOOOOHOOOHOOOOOOOHOH
OHOHOHOHOHHHHHOHOHOHOHHHHHHHHHOHHHOHHHHHOHOHHHOHHHHHHHOHOHOHHHHHHHOHOHHHHHOHHHHHHHHHHHOHHHHHHHHHOHOH
OHOHOHOHOHOOOHOHOHOHOOOOOHOOOOOHOOOOOOOHOOOHOOOHOOOOOOOHOHOHOOOHOOOHOOOOOHOHOOOHOHOOOOOHOOOOOOOHOOOH
OHOHOHOHOHOHOHOHOHHHHHOHOHOHHHOHOHOHHHOHHHHHOHHHOHHHHHHHHHOHOHOHOHHHHHOHOHHHOHOHOHOHHHHHHHHHOHHHHHHH
OHOHOOOHOOOHOOOHOOOOOHOHOOOHOHOHOOOOOHOHOHOOOOOOOHOOOOOOOOOHOHOHOOOOOHOHOOOHOHOHOOOOOOOHOOOHOOOOOOOH
OHOHHHHHHHOHHHHHHHOHOHOHHHHHOHOHOHOHOHOHOHOHHHHHHHOHHHHHHHHHOHHHHHHHOHHHHHOHOHOHHHHHHHOHOHOHHHHHOHOH
OHOOOOOOOHOOOHOOOHOHOHOOOHOOOHOHOOOHOHOHOHOHOOOHOOOOOHOOOOOOOOOOOOOHOOOOOHOOOHOOOHOOOHOHOHOOOOOOOHOH
OHHHHHHHOHOHHHOHOHOHOHHHOHOHHHOHOHOHOHOHOHOHOHOHOHHHOHHHHHOHHHHHHHOHHHHHOHHHHHOHOHOHHHOHOHHHHHHHHHOH
OOOOOOOHOHOHOOOHOOOHOOOHOHOOOOOHOHOOOHOHOHOHOHOHOOOHOOOOOHOOOHOOOHOHOOOHOHOOOHOHOHOOOHOOOHOOOHOOOHOH
OHOHHHHHOHHHOHHHOHHHHHOHOHOHHHHHHHOHHHOHOHOHOHOHHHHHHHOHOHHHHHOHOHOHOHOHOHOHOHHHOHHHOHHHHHOHOHOHHHOH
OHOOOHOOOHOOOHOHOHOOOHOHOHOHOOOOOHOHOHOHOHOHOHOOOOOOOHOHOOOOOOOHOHOOOHOHOHOHOOOHOOOHOOOOOOOHOOOHOOOH
HHHHOHOHHHOHHHOHOHOHOHHHOHOHOHHHOHOHOHOHOHOHOHHHHHHHOHOHHHHHHHHHOHOHHHOHOHOHHHOHHHOHOHHHOHHHHHHHOHHH
OOOOOHOHOOOHOHOOOHOHOOOHOHOOOHOOOHOHOOOOOHOHOHOOOOOHOHOOOOOOOHOOOHOHOOOHOHOHOOOHOOOHOHOOOHOOOOOOOHOH
OHHHHHOHHHOHOHOHHHOHHHOHOHHHHHOHHHOHOHHHHHOHOHHHOHOHOHHHHHHHHHOHHHHHOHHHOHOHHHOHOHHHOHHHHHOHHHHHHHOH
OOOOOHOOOOOHOHOHOHOOOHOOOHOOOHOOOOOHOHOOOOOHOHOOOHOHOOOOOOOHOOOHOOOHOHOOOHOOOHOOOHOOOHOOOHOHOOOOOHOH
OHHHOHHHHHHHOHOHOHHHOHHHOHOHOHHHHHOHOHOHHHHHOHOHHHOHHHHHHHOHOHHHOHOHOHOHHHOHOHHHHHOHHHOHOHOHOHHHOHOH
OOOHOOOHOOOOOHOHOOOHOOOHOHOHOOOHOOOOOHOOOOOHOHOHOOOOOOOOOHOOOHOOOHOOOHOHOOOHOHOOOHOOOHOHOOOHOOOHOHOH
HHOHOHHHOHHHOHOHOHOHHHOHOHOHHHOHOHOHHHHHHHOHOHOHHHHHHHHHHHHHHHHHOHHHOHOHOHHHOHHHOHOHOHOHHHHHOHOHOHOH
OOOHOOOHOHOHOHOHOHOOOHOHOHOHOOOHOOOHOOOHOOOHOHOOOHOOOOOOOOOOOOOOOHOOOHOHOHOOOHOOOHOHOHOOOOOHOHOHOHOH
OHHHHHOHOHOHOHOHHHOHOHOHHHOHOHHHHHOHHHOHOHHHOHOHOHOHHHHHHHOHHHHHHHHHHHOHHHOHHHOHHHOHOHHHHHOHOHOHOHOH
OHOOOHOHOHOHOHOOOOOHOHOOOHOHOHOOOOOOOOOHOHOOOHOHOOOHOOOOOHOOOHOOOOOOOOOHOOOHOHOOOOOHOOOOOHOHOHOHOHOH
OHOHOHOHOHOHOHHHHHHHOHHHOHOHOHHHHHOHHHHHOHHHOHOHHHHHHHOHOHHHOHOHHHHHHHHHOHHHOHOHHHHHOHHHHHOHHHOHOHOH
OOOHOHOOOOOHOOOOOOOOOOOHOOOHOOOOOOOOOOOOOOOOOHOOOOOOOOOHOOOHOOOOOOOOOOOOOHOOOOOOOOOHOOOOOOOOOOOHOOOH
HHHHHHHHHHHHHHHHHHHHHHHHHHHHHHHHHHHHHHHHHHHHHHHHHHHHHHHHHHHHHHHHHHHHHHHHHHHHHHHHHHHHHHHHHHHHHHHHHHHH
98
34