OOOOOOOOOH
OHHHHHHHOH
OHOOOOOHOH
HHOHHHOHOH
OOOHOOOHOH
OHHHHHHHGH
OHOOOOOHOH
OHOHHHOHOH
OOOOOHOOOH
HHHHHHHHHH
4
6